border_size=1
usage=map

Gg          , Gg          , Re^Gvs      , Re^Gvs      , Re^Gvs      , Re^Gvs      , Re^Gvs      , Re^Gvs      , Re^Gvs      , Re^Gvs      , Re^Gvs      , Gg          , Gg          , Gg          , Gg          , Gg          , Gg          , Gg          , Gg          , Gg          , Gg          , Gg          , Gg          , Gg          , Gg          , Gg          , Rp          , Rp          , Ww          , Rp          , Rp          , Rp          , Rp          , Gg          , Rp          , Gg          , Gg          , Gg          , Gg          , Gg          , Gg          , Gg          
Gg^Wm       , Re^Gvs      , Re^Gvs      , Re^Gvs      , Re^Gvs      , Re^Gvs      , Re^Gvs      , Re^Gvs      , Gg^Wm       , Re^Gvs      , Re^Gvs      , Re^Gvs      , Re^Gvs      , Gg          , Gg          , Gg          , Gg          , Gg          , Gg          , Gg          , Gg          , Gg          , Gg          , Gg          , Rp          , Rp          , Ww          , Wo          , Khw         , Wo          , Ww          , Rp          , Rp          , Rp          , Rp          , Rp          , Rp          , Gg          , Rp          , Gg          , Gg          , Gg          
Re^Gvs      , Re^Gvs      , Gg^Wm       , Re^Gvs      , Re^Gvs      , Re^Gvs      , Re^Gvs      , Re^Gvs      , Re^Gvs      , Re^Gvs      , Re^Gvs      , Re^Gvs      , Re^Gvs      , Gg          , Re^Gvs      , Gg          , Gg          , Gg          , Gg          , Gg          , Gg          , Gg          , Gg          , Gg          , Rp          , Rp          , Ww          , Khw         , Khw         , Khw         , Ww          , Rp          , Rp          , Rp          , Rp          , Gg^Vh       , Rp          , Rp          , Rp          , Rp          , Rp          , Gg          
Re^Gvs      , Re^Gvs      , Re^Gvs      , Re^Gvs      , Re^Gvs      , Re^Gvs      , Ce          , Re^Gvs      , Re^Gvs      , Re^Gvs      , Re^Gvs      , Re^Gvs      , Re^Gvs      , Re^Gvs      , Re^Gvs      , Re^Gvs      , Ce          , Ce          , Ce          , Gg          , Gg          , Gg          , Gg          , Gg          , Rp          , Rp          , Rp          , Wo          , Ww          , Wo          , Rp          , Rp          , Rp          , Gg^Vh       , Rp          , Rp          , Rp          , Rp          , Gg^Vh       , Rp          , Rp          , Rp          
Re^Gvs      , Re^Gvs      , Re^Gvs      , Re^Gvs      , Ce          , Ce          , Ce          , Ce          , Ce          , Re^Gvs      , Re^Gvs      , Re^Gvs      , Re^Gvs      , Re^Gvs      , Re^Gvs      , Re^Gvs      , Ce          , Ke          , Ce          , Gg          , Gg          , Gg          , Gg          , Gg          , Gg          , Rp          , Rp          , Rp          , Rp          , Rp          , Gg^Vh       , Rp          , Rp          , Rp          , Ch          , Ch          , Ch          , Rp          , Rp          , Rp          , Rp          , Rp          
Re^Gvs      , Re^Gvs      , Re^Gvs      , Gg^Ve       , Ce          , Ce          , 1 Ke        , Ce          , Ce          , Gg^Wm       , Re^Gvs      , Gg^Vh       , Re^Gvs      , Re^Gvs      , Re^Gvs      , Re^Gvs      , Re^Gvs      , Ce          , Gg          , Gg          , Gg          , Gg          , Gg          , Gg          , Gg          , Gg          , Gg          , Gg          , Rp          , Rp          , Rp          , Rp          , Rp          , Ch          , Kh          , Kh          , Kh          , Ch          , Rp          , Rp          , Rp          , Rp          
Re^Gvs      , Re^Gvs      , Re^Gvs      , Re^Gvs      , Ce          , Ce          , Ce          , Ce          , Ce          , Re^Gvs      , Re^Gvs      , Re^Gvs      , Re^Gvs      , Re^Gvs      , Re^Gvs      , Re^Gvs      , Gg          , Gg          , Re          , Gg          , Gg          , Gg          , Gg          , Gg          , Rr          , Gg          , Rr          , Rr          , Rr          , Gg^Vh       , Rp          , Rp          , Rr          , Ch          , Kh          , 2 Kh        , Kh          , Ch          , Rp          , Gg^Vh       , Rp          , Rp          
Re^Gvs      , Re^Gvs      , Re^Gvs      , Re^Gvs      , Gg          , Ce          , Ce          , Ce          , Re          , Re^Gvs      , Re^Gvs      , Gg^Vh       , Re^Gvs      , Re^Gvs      , Re^Gvs      , Gg^Vh       , Re          , Re          , Gg          , Re          , Rr          , Gg          , Rr          , Rr          , Gg          , Rr          , Gg          , Gg          , Gg          , Rr          , Rr          , Rr          , Rr          , Ch          , Ch          , Kh          , Ch          , Ch          , Rp          , Rp          , Rp          , Gg^Vh       
Re^Gvs      , Re^Gvs      , Re^Gvs      , Re^Gvs      , Gg^Ve       , Gg          , Re^Gvs      , Re^Gvs      , Re^Gvs      , Re          , Re          , Re^Gvs      , Re^Gvs      , Re^Gvs      , Re          , Re          , Re          , Gg          , Gg          , Gg          , Gg          , Rr          , Gg          , Gg          , Gg          , Gg          , Ce          , Gg          , Gg          , Gg          , Re          , Rp          , Rp          , Rp          , Rp          , Ch          , Rp          , Rp          , Rp          , Rp          , Rp          , Rp          
Gg          , Re^Gvs      , Re^Gvs      , Re^Gvs      , Re^Gvs      , Re^Gvs      , Re^Gvs      , Re^Gvs      , Re^Gvs      , Re^Gvs      , Re^Gvs      , Re          , Re          , Re          , Hh          , Hh          , Hh          , Re          , Re          , Gg          , Gg          , Gg          , Gg          , Gg          , Gg          , Ce          , Ke          , Ce          , Gg          , Gg          , Re          , Gg          , Rp          , Rp          , Rp          , Rp          , Gg^Vh       , Rp          , Rp          , Gg^Vh       , Rp          , Rp          
Gg          , Re^Gvs      , Re^Gvs      , Re^Gvs      , Re^Gvs      , Re^Gvs      , Re^Gvs      , Re^Gvs      , Re^Gvs      , Re^Gvs      , Re^Gvs      , Re^Gvs      , Re          , Hh          , Hh          , Hh          , Hh          , Hh          , Hh          , Re          , Re          , Gg          , Uu^Vud      , Gg          , Gg          , Ce          , Ce          , Ce          , Gg          , Gg          , Re          , Gg          , Gg          , Rp          , Gg          , Rp          , Rp          , Rp          , Rp          , Rp          , Rp          , Rp          
Gg          , Re^Gvs      , Re^Gvs      , Re^Gvs      , Re^Gvs      , Re^Gvs      , Re^Gvs      , Re^Gvs      , Re^Gvs      , Re^Gvs      , Re^Gvs      , Re^Gvs      , Re          , Hh          , Hh          , Hh          , Hh          , Hh          , Hh          , Hh          , Uu^Vud      , Ql^Bs\      , Ql^Bs\      , Uu^Vud      , Uu^Vud      , Gg          , Gg          , Gg          , Gg          , Gg          , Re          , Gg          , Gg          , Gg          , Gg          , Gg          , Gg          , Gg          , Gg          , Rp          , Gg          , Gg          
Re^Gvs      , Re^Gvs      , Re^Gvs      , Re^Gvs      , Re^Gvs      , Re^Gvs      , Re^Gvs      , Gg^Wm       , Re^Gvs      , Re^Gvs      , Re^Gvs      , Re^Gvs      , Re          , Hh          , Hh          , Hh          , Hh          , Hh          , Hh          , Hh          , Hh          , Uu^Vud      , Uu^Vud      , Ql^Bs\      , Ql^Bs\      , Uu^Vud      , Uu^Vud      , Gg          , Gg          , Gg          , Re          , Gg          , Gg          , Gg          , Gg          , Gg          , Gg          , Gg          , Gg          , Gg          , Gg          , Gg          
Re^Gvs      , Gg^Wm       , Re^Gvs      , Re^Gvs      , Re^Gvs      , Re^Gvs      , Re^Gvs      , Re^Gvs      , Re^Gvs      , Re^Gvs      , Re^Gvs      , Re^Gvs      , Re          , Hh          , Hh          , Hh          , Hh          , Hh          , Hh          , Hh          , Ha          , Hh          , Uh          , Uu^Vud      , Uu^Vud      , Ql^Bs\      , Ql^Bs\      , Re          , Re          , Re          , Qlf         , Gg          , Gg          , Gg          , Gg          , Gg          , Gg          , Gg          , Gg          , Gg          , Gg          , Gg          
Re^Gvs      , Re^Gvs      , Re^Gvs      , Re^Gvs      , Re^Gvs      , Re^Gvs      , Re^Gvs      , Re^Gvs      , Re^Gvs      , Re^Gvs      , Re^Gvs      , Re^Gvs      , Re          , Hh          , Hh          , Hh          , Ha          , Hh          , Ha          , Ha          , Ha          , Uh          , Ha          , Uh          , Uh          , Uu^Vud      , Uh          , Ql^Bs\      , Qxu^Bs\     , Qlf         , Cud         , Qlf         , Qlf         , Gg          , Gg          , Gg          , Gg          , Gg          , Gg          , Gg          , Gg          , Gg          
Rd          , Re^Gvs      , Re^Gvs      , Re^Gvs      , Rd          , Re^Gvs      , Rd          , Rd          , Rd          , Re^Gvs      , Rd          , Rd          , Re          , Hh          , Ha          , Ha          , Ha          , Ha          , Ha          , Ha          , Ha          , Ha          , Ha          , Uh          , Uh          , Uh          , Uh          , Qlf         , Cud         , Cud         , Cud         , Cud         , Cud         , Qlf         , Gg          , Gg          , Gg          , Gg          , Gg          , Gg          , Gg          , Gg          
Rd          , Rd          , Rd          , Rd          , Rd          , Rd          , Rd          , Rd          , Rd          , Rd          , Rd          , Aa^Fpa      , Re          , Aa^Fpa      , Ha          , Ha          , Ha          , Ha          , Ha          , Ha          , Ha          , Uh          , Uh          , Uh          , Uh          , Uh          , Uh          , Qlf         , Cud         , Cud         , 3 Kud       , Cud         , Cud         , Qlf         , Gg          , Gg          , Gg          , Gg          , Gg          , Gg          , Gg          , Gg          
Rd          , Rd          , Rd          , Rd          , Ce          , Rd          , Rd          , Rd          , Rd          , Rd          , Rd          , Aa^Fpa      , Re          , Aa^Fpa      , Aa^Vha      , Ha          , Ha          , Ha          , Ha          , Ha          , Ha          , Uh          , Uh          , Uh          , Uh          , Uh          , Uh          , Qlf         , Cud         , Cud         , Cud         , Cud         , Cud         , Qlf         , Gg          , Gg          , Gg          , Gg          , Gg          , Gg          , Gg          , Gg          
Rd          , Rd          , Rd          , Ce          , Ke          , Ce          , Rd          , Rd          , Rd          , Rd          , Aa^Fpa      , Aa^Fpa      , Rp          , Aa^Fpa      , Aa^Fpa      , Ha          , Ha          , Ha          , Ha          , Ha          , Ha          , Ha          , Uh          , Uh          , Uh          , Uh          , Uh          , Qlf         , Qlf         , Cud         , Cud         , Cud         , Qlf         , Qlf         , Qlf         , Gg          , Gg          , Gg          , Gg          , Gg          , Gg          , Gg          
Rd          , Rd          , Rd          , Ce          , Ce          , Ce          , Rd          , Rd          , Aa^Fpa      , Aa^Fpa      , Aa^Fpa      , Aa^Fpa      , Rp          , Aa^Fpa      , Aa^Vea      , Aa^Fpa      , Ha          , Ha          , Ha          , Ha          , Uh          , Ha          , Uh          , Uh          , Uh          , Uh          , Gg          , Gg          , Gg          , Qlf         , Qxu^Bs|     , Qlf         , Gg          , Gg          , Gg          , Qlf         , Gg          , Gg          , Gg          , Gg          , Gg          , Gg          
Rd          , Rd          , Rd          , Rd          , Rd          , Rd          , Aa          , Aa          , Ha          , Aa^Vha      , Ha          , Aa          , Rp          , Aa^Fpa      , Aa^Fpa      , Aa^Fpa      , Aa^Vea      , Ha          , Ha          , Ha          , Uh          , Uh          , Uh          , Uh          , Gg          , Gg          , Gg          , Gg          , Gg          , Gg          , Qxu^Bs|     , Gg          , Gg          , Gg          , Gg          , Qlf         , Qlf         , Gg          , Gg          , Gg          , Gg          , Gg          
Gg          , Rd          , Gg          , Rd          , Aa^Vea      , Aa          , Ha          , Aa          , Ha          , Ha          , Aa          , Aa          , Cv          , Aa          , Aa          , Aa          , Ha          , Ha          , Ha          , Ha          , Ha          , Ha          , Gg          , Gg          , Gg          , Gg          , Gg          , Gg          , Gg          , Gg          , Qxu^Bs|     , Gg          , Gg          , Gg          , Gg          , Gg          , Qlf         , Gg          , Gg          , Gg          , Gg          , Gg          
Gg          , Gg          , Gg          , Gg          , Aa          , Ha          , Ha          , Ha          , Aa          , Aa          , Cv          , Cv          , Kv          , Cv          , Cv          , Aa          , Aa^Vea      , Ha          , Ha          , Gg          , Gg          , Gg          , Gg          , Gg          , Gg          , Gg          , Gg          , Gg          , Gg          , Gg          , Gs          , Gg          , Ce          , Ce          , Ce          , Gg          , Qlf         , Gg          , Gg          , Gg          , Gg          , Gg          
Gg          , Gg          , Gg          , Aa          , Aa          , Ha          , Aa^Vea      , Ha          , Aa          , Aa          , Cv          , Kv          , 4 Kv        , Kv          , Cv          , Re          , Re          , Re          , Re          , Re          , Re          , Re          , Re          , Re          , Re          , Gg          , Gg          , Gg          , Re          , Re          , Gs          , Gg          , Ce          , Ce          , Ce          , Gg          , Qlf         , Gg          , Gg          , Gg          , Gg          , Gg          
Gg          , Gg          , Gg          , Aa          , Aa          , Aa          , Ha          , Ha          , Aa          , Aa          , Cv          , Kv          , Kv          , Kv          , Cv          , Re          , Aa          , Ha          , Ha          , Gg          , Gg          , Gg          , Gg          , Gg          , Gg          , Re          , Re          , Re          , Gg          , Re          , Gs          , Gg          , Gg          , Ce          , Gg          , Gg          , Qlf         , Gg          , Gg          , Gg          , Gg          , Gg          
Gg          , Gg          , Gg          , Aa^Vea      , Aa          , Aa          , Ha          , Ha          , Ha          , Aa          , Aa          , Cv          , Cv          , Cv          , Ai          , Aa          , Ha          , Ha          , Ha          , Gg          , Gg          , Gg          , Gg          , Gg          , Gg          , Gg          , Gg          , Gg          , Gg          , Gg          , Gs          , Gg          , Gg          , Gg          , Gg          , Gg          , Qlf         , Gg          , Gg          , Gg          , Gg          , Gg          
Gg          , Gg          , Gg          , Aa          , Aa          , Aa          , Aa          , Ha          , Aa          , Ha          , Aa^Vea      , Ha          , Re          , Ha          , Ha          , Ai          , Ai          , Aa^Vea      , Gg          , Gg          , Gg          , Gg          , Gg          , Gg          , Gg          , Gg          , Gg          , Gg          , Gg          , Ss          , Ss^Bw|      , Ss          , Gg          , Gg          , Gg          , Gg          , Qlf         , Gg          , Gg          , Gg          , Gg          , Gg          
Gg          , Gg          , Gg          , Gg          , Gg          , Aa          , Gg          , Aa          , Gg          , Gg          , Gg          , Ha          , Re          , Aa          , Aa          , Aa          , Gg          , Ai          , Ai          , Gg          , Gg          , Gg          , Gg          , Gg          , Gg          , Gg          , Gg          , Gg          , Gg          , Ss          , Ss^Bw|      , Ss          , Gg          , Gg          , Gg          , Gg          , Qlf         , Gg          , Gg          , Gg          , Gg          , Gg          
Gg          , Gg          , Gg          , Gg          , Gg          , Gg          , Gg          , Gg          , Gg          , Gg          , Gg          , Ha          , Re          , Ha          , Aa^Vha      , Aa^Vha      , Gg          , Gg          , Gg          , Ai          , Ai          , Gg          , Gg          , Gg          , Gg          , Gg          , Gg          , Gg          , Gg          , Ss          , Ss^Bw|      , Ss          , Gg          , Gg          , Gg          , Gg          , Qlf         , Gg          , Gg          , Gg          , Gg          , Gg          
Gg          , Gg          , Gg          , Gg          , Gg          , Gg          , Gg          , Gg          , Gg          , Gg          , Gg          , Aa^Vha      , Re          , Ha          , Gg          , Aa^Vha      , Gg          , Gg          , Gg          , Gg          , Gg          , Ai          , Ai          , Gg          , Gg          , Gg          , Gg          , Gg          , Gg          , Ss          , Ww^Bw|      , Ss          , Ss          , Ss          , Ss          , Ss          , Qlf         , Gg          , Gg          , Gg          , Gg          , Gg          
Gg          , Gg          , Gg          , Gg          , Ce          , Gg          , Gg          , Gg          , Gg          , Gg          , Gg          , Ha          , Re          , Ha          , Gg          , Gg          , Gg          , Gg          , Gg          , Gg          , Gg          , Gg          , Gg          , Ai          , Ai          , Gg          , Ss          , Ss          , Ss          , Ss          , Ww^Bw|      , Ss          , Ww          , Ww          , Ww          , Ww          , Ww          , Ss          , Ss          , Ss          , Ss          , Gg          
Gg          , Gg          , Gg          , Ce          , Ce          , Ce          , Gg          , Gg          , Gg          , Gg          , Gg          , Gg          , Re          , Gg          , Gg          , Gg          , Gg          , Gg          , Gg          , Gg          , Gg          , Gg          , Gg          , Gg          , Ss          , Ai          , Ww          , Ww          , Ww          , Ww          , Ww^Bw|      , Ww          , Ww          , Ww          , Ww^Vm       , Ww          , Ww          , Ww          , Ww          , Ww          , Ww          , Ss          
Gg          , Gg          , Gg          , Ce          , Ce          , Ce          , Gg          , Gg          , Gg          , Gg          , Gg          , Gg          , Re          , Gg          , Gg          , Gg          , Gg          , Gg          , Gg          , Gg          , Gg          , Gg          , Gg          , Gg          , Ss          , Ww          , Ww          , Ww^Vm       , Ww          , Ww          , Ww^Bw|      , Ww          , Ww^Vm       , Ww          , Ww          , Ww          , Ww^Vm       , Ww          , Ww          , Ww          , Ww          , Ww          
Gg          , Gg          , Gg          , Gg          , Gg          , Gg          , Gg          , Gg          , Gg          , Gg          , Gg          , Gg          , Rd          , Gg          , Gg          , Gg          , Gg          , Gg          , Gg          , Gg          , Gg          , Gg          , Gg          , Gg          , Ss          , Ww          , Ww          , Ww          , Ww          , Ww          , Wwf         , Ww          , Ww          , Ww          , Ww^Vm       , Ww          , Ww          , Ww          , Ww          , Ww          , Ww          , Ww          
Gg          , Gg          , Gg          , Gg          , Gg          , Gg          , Gg          , Gg          , Gg          , Gg          , Rd          , Rd          , Gg          , Gg          , Gg          , Gg          , Gg          , Gg          , Gg          , Gg          , Gg          , Gg          , Gg          , Ss          , Ww          , Ww          , Ww^Vm       , Ww          , Ww          , Wwf         , Wwf         , Wwf         , Ww          , Ww          , Ww          , Ww          , Ww          , Ww          , Ww          , Ww^Vm       , Ww          , Ww          
Gg          , Gg          , Hd          , Gg          , Hd          , Gg          , Hd          , Gg          , Gg          , Rd          , Gg          , Gg          , Hd          , Gg          , Gg          , Gg          , Gg          , Gg          , Gg          , Gg          , Gg          , Gg          , Ss          , Ss          , Ww          , Ww          , Ww          , Ww          , Ww          , Ww^Vm       , Wo          , Wo          , Wo          , Ww^Vm       , Ww          , Ww          , Ww          , Ww          , Ww^Vm       , Ww          , Ww          , Ww          
Hd          , Hd          , Hd          , Hd          , Hd          , Dd^Vdt      , Hd          , Hd          , Hd          , Rd          , Hd          , Hd          , Hd          , Hd          , Hd          , Gg          , Gg          , Gg          , Gg          , Gg          , Ce          , Gg          , Ss          , Ww          , Ww          , Ww          , Ww          , Ww          , Wo          , Wo          , Wo          , Wo          , Wo          , Wo          , Wo          , Ww          , Ww          , Ww          , Ww          , Ww          , Ww          , Ww          
Hd          , Hd          , Hd          , Hd          , Hd          , Hd          , Hd          , Hd          , Hd          , Ds          , Hd          , Hd          , Hd          , Hd          , Dd^Dr       , Hd          , Hd          , Gg          , Gg          , Ce          , Ke          , Ce          , Ss          , Ww          , Ww          , Ww          , Ww          , Wo          , Wo          , Wo          , Chw         , Chw         , Chw         , Wo          , Wo          , Wo          , Ww          , Ww          , Ww          , Ww          , Ww          , Ww          
Hd          , Hd          , Dd^Vdt      , Hd          , Hd          , Dd^Dc       , Dd^Dc       , Hd          , Hd          , Ds          , Dd^Dr       , Hd          , Hd          , Hd          , Dd          , Hd          , Hd          , Hd          , Hd          , Ce          , Ce          , Ce          , Ss          , Ww          , Ww          , Ww          , Ww          , Wo          , Wo          , Chw         , Chw         , Chw         , Chw         , Chw         , Wo          , Wo          , Ww          , Ww^Vm       , Ww          , Ww          , Ww          , Ww          
Hd          , Hd          , Hd          , Hd          , Hd          , Hd          , Hd          , Hd          , Ce          , Ds          , Hd          , Hd          , Hd          , Dd          , Dd^Do       , Dd^Vdt      , Hd          , Hd          , Hd          , Gg          , Ss          , Ss          , Ww          , Ww          , Ww          , Ww          , Ww          , Wo          , Wo          , Chw         , Chw         , 6 Khw       , Chw         , Chw         , Wo          , Wo          , Ww^Vm       , Ww          , Ww          , Ww          , Ww          , Ww          
Hd          , Hd          , Hd          , Hd          , Hd          , Hd          , Ce          , Ce          , Ce          , Ce          , Ce          , Hd          , Hd          , Dd          , Dd          , Dd          , Hd          , Hd          , Dd^Vdt      , Hd          , Ss          , Ww          , Ww          , Ww          , Ww          , Ww          , Ww^Vm       , Wo          , Wo          , Chw         , Chw         , Chw         , Chw         , Chw         , Wo          , Wo          , Ww          , Ww          , Ww          , Ww          , Ww^Vm       , Ww          
Hd          , Hd          , Hd          , Dd^Vdt      , Hd          , Hd          , Ce          , Ce          , 5 Ke        , Ce          , Ce          , Hd          , Hd          , Hd          , Dd^Dr       , Hd          , Hd          , Dd          , Dd          , Dd          , Ss          , Ww          , Ww          , Ww          , Ww          , Ww          , Ww          , Wo          , Wo          , Wo          , Wo          , Chw         , Wo          , Wo          , Wo          , Ww^Vm       , Ww          , Ww          , Ww          , Ww          , Ww          , Ww          
Hd          , Hd          , Hd          , Hd          , Hd          , Hd          , Ce          , Ce          , Ce          , Ce          , Ce          , Hd          , Dd^Dr       , Hd          , Hd          , Hd          , Hd          , Dd          , Dd          , Dd          , Ss          , Ww          , Ww          , Ww          , Ww          , Ww          , Ww          , Ww          , Ww          , Wo          , Wo          , Wo          , Wo          , Wo          , Ww          , Ww          , Ww          , Ww          , Ww          , Ww          , Ww          , Ww          
Hd          , Dd^Vdt      , Hd          , Hd          , Hd          , Hd          , Ds          , Ce          , Ce          , Ce          , Ds          , Hd          , Hd          , Hd          , Hd          , Hd          , Hd          , Dd^Vdt      , Hd          , Hd          , Ss          , Ww          , Ww          , Ww          , Ww          , Ww          , Ww          , Ww          , Ww          , Ww          , Ww          , Wo          , Ww          , Ww          , Ww          , Ww          , Ww          , Ww          , Ww          , Ww          , Ww          , Ww          
