border_size=1
usage=map

Wo          , Wo          , Wo          , Wo          , Wo          , Gs^Vht      , Gs^Vht      , Gs^Vht      , Gs^Vht      , Gs^Vht      , Hh^Vhh      , Hh^Vhh      , Hh^Vhh      , Hh^Vhh      , Hh^Vhh      , Wo          , Wo          , Wo          , Wo          , Wo          , Wo          , Wo          , Wo          , Wo          , Wo          , Wo          , Wo          , Wo          , Wo          , Wo          , Wo          , Wo          , Wo          , Wo          , Wo          , Wo          , Wo          , Wo          , Wo          , Wo          , Wo          , Wo          
Wo          , Wo          , Wo          , Wo          , Wo          , Gs^Vht      , Gs^Vht      , Gs^Vht      , Gs^Vht      , Gs^Vht      , Hh^Vhh      , Hh^Vhh      , Hh^Vhh      , Hh^Vhh      , Hh^Vhh      , Wo          , Wo          , Wo          , Wo          , Wo          , Wo          , Wo          , Wo          , Wo          , Wo          , Wo          , Chw         , Khw         , Chw         , Wo          , Ch          , Ch          , Ch          , Wo          , Ch          , Ch          , Ch          , Wo          , Wo          , Wo          , Wo          , Wo          
Wo          , Wo          , Wo          , Wo          , Wo          , Gs^Vht      , Gs^Vht      , Gs^Vht      , Gs^Vht      , Gs^Vht      , Hh^Vhh      , Hh^Vhh      , Hh^Vhh      , Hh^Vhh      , Hh^Vhh      , Wo          , Ww^Vm       , Wo          , Wo          , Wo          , Wo          , Ww^Vm       , Wo          , Wo          , Wo          , Wo          , Wo          , Wo          , Wo          , Ch          , Ch          , Ch          , Ch          , Ch          , Ch          , Ch          , Ch          , Ch          , Wo          , Wo          , Wo          , Wo          
Wo          , Wo          , Wo          , Wo          , Gg^Ve       , Gg^Ve       , Gg^Ve       , Gs^Vht      , Gg^Vc       , Gg^Vc       , Gg^Vc       , Hh^Vhh      , Hh^Vhh      , Hh^Vhh      , Gg^Vh       , Wo          , Wo          , Wo          , Wo          , Wo          , Wo          , Wo          , Wo          , Wo          , Wo          , Ww^Vm       , Wo          , Wo          , Wo          , Ch          , Ch          , Ch          , Kh          , Kh          , Kh          , Ch          , Ch          , Ch          , Wo          , Ww^Vm       , Chw         , Wo          
Wo          , Wo          , Wo          , Gg^Ve       , Gg^Ve       , Gg^Ve       , Gg^Ve       , Gg^Ve       , Gg^Vc       , Gg^Vc       , Gg^Vc       , Gg^Vc       , Gg^Vh       , Gg^Vh       , Gg^Vh       , Gg^Vh       , Gg^Vh       , Wo          , Wo          , Wo          , Ww^Vm       , Wo          , Wo          , Wo          , Wo          , Wo          , 6 Khw       , Wo          , Wo          , Ch          , Ch          , Ch          , Kh          , Kh          , Kh          , Ch          , Ch          , Ch          , Wo          , 7 Khw       , Chw         , Wo          
Wo          , Wo          , Wo          , Gg^Ve       , Gg^Ve       , Gg^Ve       , Gg^Ve       , Gg^Ve       , Gg^Vc       , Gg^Vc       , Gg^Vc       , Gg^Vc       , Gg^Vh       , Gg^Vh       , Gg^Vh       , Gg^Vh       , Gg^Vh       , Wo          , Wo          , Wo          , Wo          , Wo          , Wo          , Wo          , Wo          , Chw         , Wo          , Chw         , Wo          , Wo          , Wo          , Ch          , Ch          , Kh          , Ch          , Ch          , Wo          , Wo          , Wo          , Wo          , Wo          , Wo          
Wo          , Wo          , Wo          , Gg^Ve       , Gg^Ve       , Gg^Ve       , Gg^Ve       , Gg^Ve       , Gg^Vc       , Gg^Vc       , Gg^Vc       , Gg^Vc       , Gg^Vh       , Gg^Vh       , Gg^Vh       , Gg^Vh       , Gg^Vh       , Wo          , Wo          , Wo          , Wo          , Wo          , Wo          , Wo          , Wo          , Wo          , Ww^Vm       , Wo          , Wo          , Wo          , Wo          , Ch          , Ch          , Ch          , Ch          , Ch          , Wo          , Wo          , Wo          , Wo          , Wo          , Wo          
Wo          , Wo          , Wo          , Wo          , Wo          , Gg^Ve       , Wo          , Wo          , Wo          , Gg^Vc       , Wo          , Wo          , Wo          , Gg^Vh       , Gg^Vh       , Gg^Vh       , Wo          , Wo          , Wo          , Wo          , Wo          , Wo          , Wo          , Wo          , Wo          , Wo          , Wo          , Wo          , Khw         , Wo          , Wo          , Ch          , Ch          , Ch          , Ch          , Ch          , Wo          , Wo          , Ww^Vm       , Wo          , Wo          , Wo          
Wo          , Wo          , Wo          , Wo          , Wo          , Wo          , Wo          , Wo          , Wo          , Wo          , Wo          , Wo          , Wo          , Wo          , Wo          , Wo          , Wo          , Wo          , Wo          , Wo          , Wo          , Wo          , Wo          , Wo          , Wo          , Wo          , Wo          , Chw         , Wo          , Chw         , Wo          , Wo          , Wo          , Ch          , Wo          , Wo          , Wo          , Wo          , Khw         , Wo          , Wo          , Wo          
Wo          , Wo          , Wo          , Wo          , Wo          , Wo          , Wo          , Wo          , Wo          , Wo          , Wo          , Wo          , Wo          , Wo          , Wo          , Wo          , Wo          , Wo          , Wo          , Wo          , Wo          , Wo          , Wo          , Wo          , Wo          , Wo          , Wo          , Wo          , Ww^Vm       , Wo          , Wo          , Wo          , Wo          , Ww^Bw|      , Wo          , Wo          , Wo          , Chw         , Wo          , Chw         , Wo          , Wo          
Wo          , Wo          , Wo          , Wo          , Wo          , Wo          , Wo          , Wo          , Wo          , Wo          , Wo          , Wo          , Wo          , Wo          , Wo          , Wo          , Wo          , Wo          , Wo          , Wo          , Wo          , Wo          , Wo          , Wo          , Wo          , Wo          , Wo          , Wo          , Wo          , Wo          , Wo          , Wo          , Wo          , Ww^Bw|      , Wo          , Wo          , Ww          , Wo          , Ww          , Ww          , Ww          , Ww          
Wo          , Wo          , Wo          , Wo          , Wo          , Wo          , Wo          , Wo          , Wo          , Wo          , Wo          , Wo          , Wo          , Wo          , Wo          , Wo          , Wo          , Wo          , Ww          , Wo          , Ww          , Wo          , Ww          , Wo          , Ww          , Ww          , Ww          , Ww^Vm       , Ww          , Wo          , Ww          , Wo          , Ww          , Ww          , Ww          , Ww          , Ww          , Ww          , Ww          , Ww          , Ww          , Ww          
Wo          , Wo          , Wo          , Wo          , Wo          , Wo          , Wo          , Wo          , Wo          , Wo          , Ww          , Wo          , Ww          , Wo          , Ww          , Wo          , Ww          , Ww          , Ww          , Ww          , Ww          , Ww          , Ww          , Ww^Vm       , Ww          , Ww          , Ww          , Ww          , Ww          , Ww          , Ww          , Ww          , Ww          , Ww          , Ww          , Ww          , Ww          , Ww          , Ww          , Ww          , Ww          , Ww          
Ww          , Ww          , Ww          , Ww          , Ww          , Ww          , Ww          , Ww          , Ww          , Ww          , Ww          , Ww          , Ww          , Ww          , Ww          , Ww          , Ww          , Ww          , 2 Ke        , Ww          , Ww          , Ww          , Ww          , Ww          , Ww          , Ww          , Ww          , Ww          , Ww          , Ww          , Ww          , Ww          , Ww          , Ww          , Ww          , Ww          , Ww          , Ww          , Ww          , Ww          , Qlf         , Gg          
Ww          , Ww          , Ww          , Ww          , Ww          , Ww          , Ww          , Ww          , Ww          , Ww          , Ww          , Ww          , Ww          , Ww          , Ww          , Ww          , Ww          , Ce          , Dd^Vdt      , Ce          , Ww          , Ww          , Ww          , Ww          , Ww          , Ww          , Ww          , Ww          , Ww          , Ww          , Ww          , Ww          , Ww          , Ww          , Ww          , Ww          , Ww          , Ww          , Cud         , Cud         , Cud         , Qlf         
Ww          , Ww          , Ww^Vm       , Ww          , Ww          , Ww          , Ww          , Ww          , Ww          , Ww          , Ww          , Ww          , Ww          , Ww          , Ww          , Ww          , Ww          , Dd^Vdt      , Dd^Vdt      , Dd^Vdt      , Ww          , Ww          , Ww          , Ww          , Ww          , Ww          , Ww          , Ww          , Ww^Vm       , Ww          , Ww          , Ww          , Ww          , Ww          , Ww          , Ww          , Cud         , Cud         , Cud         , Cud         , Cud         , Cud         
Ww          , Ww          , Ww          , Ww          , Ww          , Ww          , Ww          , Ww          , Ww          , Ww^Vm       , Ww          , Ww          , Ww          , Ww          , Ww          , Ww          , Ww          , Ww          , Ww^Bw|      , Ww          , Ww          , Ww          , Ww          , Ww          , Ww          , Ww          , Ww          , Ww          , Ww          , Ww          , Ww          , Ww          , Ww          , Ww          , Uu          , Cud         , Cud         , Cud         , Cud         , Cud         , Cud         , Cud         
Ww          , Ww          , Ww          , Ww          , Ww          , Ww          , Ww          , Ww          , Ww          , Ww          , Ww          , Ww          , Ww          , Ww          , Ww          , Ww          , Ww          , Ww          , Ww^Bw|      , Ww          , Ww          , Ww          , Ww          , Ww^Vm       , Ww          , Ww          , Ww          , Ww          , Ww          , Ww          , Ww          , Ww          , Qlf         , Uu          , Uu          , Uu          , Uu^Ii       , Cud         , Cud         , Cud         , Cud         , Cud         
Ww          , Ww          , Ww          , Ww          , Ww          , Ww          , Ww^Vm       , Ww          , Ww          , Ww          , Ww          , Ww          , Ww          , Ww^Vm       , Ww          , Ww          , Ww          , Ww          , Ww          , Ww          , Ww          , Ww          , Ww          , Ww          , Ww          , Ww          , Ww          , Ww          , Ww          , Ww          , Qlf         , Qlf         , Qlf         , Uu          , Uu          , Uu          , Uu          , Cud         , Cud         , Cud         , Cud         , Uu          
Ww          , Ww          , Ww          , Ww          , Ww          , Ww          , Ww          , Ww          , Ww          , Ww          , Ww          , Ww          , Ww          , Ww          , Ww          , Ww          , Ww          , Ww          , Ww          , Ww          , Ww          , Ww          , Ww          , Ww          , Ww          , Ww          , Ww          , Ww          , Ww          , Qlf         , Qlf         , Qlf         , Qxu^Bs/     , Uu          , Uu          , Uu          , Uu          , 5 Kud       , Uu          , Cud         , Uu^Ii       , Uu          
Ww          , Ww          , Ww          , Ww          , Ww          , Ww          , Ww          , Ww          , Ww          , Ww          , Ww          , Ww          , Ww          , Ww          , Ww          , Ww          , Ww          , Ww          , Ww          , Ww          , Ww          , Ww          , Ww          , Ww          , Ww          , Ww          , Re^Gvs      , Gg^Wm       , Re^Gvs      , Ww          , Qxu^Bs/     , Qxu^Bs/     , Qlf         , Qlf         , Qlf         , Uu          , Uu          , Ql          , Ql          , Uu          , Uu          , Uu          
Ww          , Ww          , Ww          , Ww^Vm       , Ww          , Ww          , Ww          , Ww          , Ww          , Ww          , Ww          , Ww          , Ww          , Ww          , Ww          , Ww          , Ww          , Ww          , Ww          , Ww          , Ww          , Ww          , Ww          , Ww          , Gg^Wm       , Re^Gvs      , Re^Gvs      , Re^Gvs      , Re^Gvs      , Re^Gvs      , Ww          , Ww          , Ww          , Qlf         , Qlf         , Qlf         , Qlf         , Uu          , Uu          , Uu          , Uu          , Uu          
Ww          , Ww          , Ww          , Ww          , Ww          , Ww          , Ww          , Ww          , Ww          , Ww^Vm       , Ww          , Ww          , Ww          , Ww          , Ww          , Ww          , Ww          , Ww          , Ww          , Ww          , Ww          , Ww          , Re^Gvs      , Re^Gvs      , Re^Gvs      , Re^Gvs      , Re^Gvs      , Gg^Wm       , Ww          , Ww          , Kh          , Kh          , Kh          , Ww          , Ww          , Qlf         , Qxu^Bs/     , Qxu^Bs/     , Qlf         , Uu          , Qlf         , Qlf         
Rd          , Ww          , Ww          , Ww          , Ww          , Ww          , Ww          , Ww          , Ww          , Ww          , Ww          , Ww          , Ww          , Ww          , Ww          , Ww          , Ww          , Ww          , Ww          , Ww          , Ww          , Gg^Wm       , Re^Gvs      , Re^Gvs      , Ww          , Re^Gvs      , Ww          , Ww          , Rr          , Kh          , Ch          , Ch          , Ch          , Kh          , Rr          , Qxu^Bs/     , Qlf         , Qlf         , Qlf         , Qlf         , Qlf         , Qlf         
Rd          , Rd          , Rd          , Ww          , Ww          , Ww          , Ww          , Ww          , Ww          , Ww          , Ww          , Ww          , Ww          , Ww          , Ww          , Ww          , Ww          , Ww          , Ds          , Ds          , Ds          , Ww          , Ww          , Ww^Bw\      , Ww^Bw\      , Ww          , Ww          , Rr          , Rr          , Kh          , Ch          , 1 Kh        , Ch          , Kh          , Rr          , Ww          , Gg          , Qlf         , Gg          , Qlf         , Gg          , Gg          
Rd          , Rd          , Rd          , Rd          , Rd          , Ww          , Ww          , Ww          , Ww          , Ww          , Ww^Vm       , Ww          , Ww          , Ww          , Ww          , Ww          , Ds          , Ds          , Ds          , Ds          , Ds          , Ds          , Ww          , Ww          , Ww          , Ww^Bw\      , Ww^Bw\      , Rr          , Rr          , Kh          , Kh          , Ch          , Kh          , Kh          , Rr          , Ww          , Gg          , Gg          , Gg          , Gg          , Gg          , Gg          
Rd          , Rd          , Rd          , Rd          , Rd          , Rd          , Rd          , Ww          , Ww          , Ww          , Ww          , Ww          , Ww          , Ww          , Ds          , Dd          , Dd          , Ds          , Ds          , Ds          , Ds          , Ds          , Ww          , Ww          , Ww          , Ww          , Ww          , Ww^Bw\      , Rr          , Rr          , Rr          , Kh          , Rr          , Rr          , Rr          , Ww          , Gg          , Gg          , Gg          , Gg          , Gg          , Gg          
Rd          , Rd          , Rd          , Rd          , Rd          , Rd          , Rd          , Rd          , Rd          , Ww          , Ww          , Ww          , Ds          , Ds          , Dd^Vda      , Ds          , Dd          , Dd          , Hd          , Ds          , Ds          , Ds          , Hd          , Ww          , Ww          , Ww          , Gg          , Gg          , Gg          , Rr          , Rr          , Rr          , Rr          , Rr          , Dd^Vdt      , Ww          , Gg          , Gg          , Gg          , Gg          , Gg          , Gg          
Rd          , Rd          , Rd          , Rd          , Rd          , Rd          , Rd          , Rd          , Rd          , Rd          , Ww          , Ds          , Dd          , Dd          , Ds          , Ds          , Dd          , Hd          , Hd          , Ds          , Dd^Do       , Ds          , Hd          , Dd^Do       , Ww          , Gg          , Gg          , Gg          , Gg          , Gg          , Gg          , Gg          , Gg          , Gg          , Gg          , Ww          , Gg          , Gg          , Gg          , Gg          , Gg          , Gg          
Rd          , Rd          , Rd          , Rd          , Rd          , Rd          , Rd          , Rd          , Rd          , Rd          , Ww          , Ds          , Dd          , Ds          , Dd          , Dd          , Hd          , Hd          , 9 Ds        , Ds          , Dd          , Dd          , Ds          , Hd          , Ww          , Gg          , Gg          , Gg          , Gg          , Gg          , Ce          , Gg          , Gg          , Gg          , Gg          , Ww          , Gg          , Gg          , Gg          , Gg          , Gg          , Gg          
Rd          , Rd          , Rd          , Rd          , Rd          , Rd          , Rd          , Rd          , Rd          , Rd          , Ww^Bw/      , Ds          , Ds          , Ds          , Dd          , Dd          , Ds          , Dd          , Dd          , Dd          , Ds          , Dd          , Ds          , Dd^Vdt      , Ww          , Gg          , Dd^Vdt      , Gg          , Gg          , Ce          , 8 Ke        , Gg          , Gg          , Gg          , Gg          , Ww          , Gg          , Gg          , Gg          , Gg          , Gg          , Gg          
Rd          , Rd          , Rd          , Rd          , Rd          , Rd          , Rd          , Rd          , Rd          , Rd          , Rd          , Ww          , Ww          , Ds          , Dd          , Ds          , Dd^Vda      , Dd          , Dd          , Dd          , Dd          , Ds          , Ds          , Hd          , Ww          , Gg          , Gg          , Gg          , Gg          , Gg          , Gg          , Gg          , Gg          , Gg          , Gg          , Ww          , Gg          , Gg          , Gg          , Gg          , Gg          , Gg          
Rd          , Rd          , Dd^Vdt      , Rd          , Rd          , Rd          , Rd          , Rd          , Dd^Vdt      , Rd          , Rd          , Rd          , Rd          , Ww^Vm       , Dd          , Ds          , Ds          , Ds          , Ds          , Ds          , Dd          , Ds          , Hd          , Hd          , Ww          , Gg          , Gg          , Gg          , Ww          , Ww          , Ww          , Gg          , Gg          , Gg          , Gg          , Ww          , Gg          , Gg          , Gg          , Gg          , Gg          , Gg          
Rd          , Rd          , Rd          , Rd          , Rd          , Rd          , Rd          , Rd          , Rd          , Rd          , Rd          , Rd          , Rd          , Ww          , Ds          , Dd          , Dd          , Ds          , Dd          , Ds          , Hd          , Ds          , Ds          , Dd^Vda      , Ds          , Ww          , Ww          , Ww          , Rd          , Rd          , Rd          , Ww          , Ww          , Gg          , Gg          , Ww          , Gg          , Gg          , Gg          , Gg          , Gg          , Gg          
Rd          , Rd          , Rd          , Rd          , Rd          , Rd          , Rd          , Rd          , Rd          , Rd          , Rd          , Rd          , Rd          , Ww          , Ds          , Dd^Do       , Ds          , Hd          , Ds          , Dd          , Ds          , Ds          , Ds          , Ds          , Ww          , Ww          , Rd          , Rd          , Rd          , Rd          , Rd          , Gg          , Gg          , Ww          , Ww          , Ww          , Gg          , Gg          , Gg          , Gg          , Gg          , Gg          
Rd          , Rd          , Rd          , Rd          , Rd          , Rd          , Rd          , Rd          , Ce          , Rd          , Rd          , Rd          , Rd          , Ww          , Ww          , Ds          , Ds          , Ds          , Ww          , Ds          , Ds          , Ds          , Ww^Bw\      , Ww          , Rd          , Rd          , Rd          , Rd          , Rd          , Rd          , Rd          , Gg          , Gg          , Gg          , Gg          , Ww          , Gg          , Gg          , Gg          , Gg          , Gg          , Gg          
Rd          , Rd          , Rd          , Rd          , Rd          , Rd          , Rd          , 3 Ke        , Ce          , Ce          , Rd          , Rd          , Rd          , Rd          , Rd          , Ww          , Ww          , Ww          , Rd          , Ww          , Ww          , Ww          , Rd          , Rd          , Rd          , Rd          , Rd          , Rd          , Rd          , Rd          , Rd          , Gg          , Gg          , Gg          , Gg          , Gg          , Gg          , Gg          , Gg          , Gg          , Gg          , Gg          
Rd          , Rd          , Rd          , Rd          , Rd          , Dd^Vdt      , Rd          , Rd          , Rd          , Rd          , Rd          , Rd          , Rd          , Rd          , Rd          , Rd          , Rd          , Rd          , Rd          , Rd          , Rd          , Rd          , Rd          , Rd          , Rd          , Rd          , Rd          , Rd          , Rd          , Rd          , Rd          , Gg          , Gg          , Gg          , Gg          , Gg          , Gg          , Gg          , Ce          , Ce          , Gg          , Gg          
Rd          , Rd          , Rd          , Rd          , Rd          , Rd          , Rd          , Rd          , Rd          , Rd          , Rd          , Rd          , Rd          , Rd          , Rd          , Rd          , Rd          , Rd          , Rd          , Rd          , Rd          , Rd          , Rd          , Rd          , Dd^Vdt      , Rd          , Rd          , Rd          , Rd          , Rd          , Rd          , Gg          , Gg          , Gg          , Gg          , Gg          , Gg          , Gg          , Ce          , 4 Ke        , Gg          , Gg          
Rd          , Rd          , Rd          , Rd          , Rd          , Rd          , Rd          , Rd          , Rd          , Rd          , Rd          , Dd^Vdt      , Rd          , Rd          , Rd          , Rd          , Rd          , Rd          , Rd          , Rd          , Rd          , Rd          , Rd          , Rd          , Rd          , Rd          , Rd          , Rd          , Rd          , Rd          , Rd          , Gg          , Gg          , Gg          , Dd^Vdt      , Gg          , Gg          , Gg          , Gg          , Gg          , Gg          , Gg          
Rd          , Rd          , Rd          , Rd          , Rd          , Rd          , Rd          , Rd          , Rd          , Rd          , Rd          , Rd          , Rd          , Rd          , Rd          , Rd          , Rd          , Rd          , Rd          , Rd          , Rd          , Rd          , Rd          , Rd          , Rd          , Rd          , Rd          , Rd          , Rd          , Rd          , Rd          , Gg          , Gg          , Gg          , Gg          , Gg          , Gg          , Gg          , Gg          , Gg          , Gg          , Gg          
Rd          , Rd          , Rd          , Rd          , Rd          , Rd          , Rd          , Rd          , Rd          , Rd          , Rd          , Rd          , Rd          , Rd          , Rd          , Rd          , Rd          , Rd          , Rd          , Rd          , Rd          , Rd          , Rd          , Rd          , Rd          , Rd          , Rd          , Rd          , Rd          , Rd          , Gg          , Gg          , Gg          , Gg          , Gg          , Gg          , Gg          , Gg          , Gg          , Gg          , Gg          , Gg          
