border_size=1
usage=map

Wo          , Wo          , Wo          , Wo          , Wo          , Wo          , Cv          , Cv          , Cv          , Ww          , Cv          , Cv          , Gg^Vh       , Ww          , Gg^Vh       , Ww          , Aa^Vea      , Ww          , Wo          , Ww          , Wo          , Ww          
Wo          , Wo          , Wo          , Wo          , Wo          , Wo          , Cv          , Cv          , Cv          , Cv          , Cv          , Cv          , Gg^Vh       , Gg^Vh       , Ss^Vhs      , Ww^Vm       , Gg^Vc       , Dd^Vda      , Wo          , Wo          , Wo          , Wo          
Wo          , Wo          , Wo          , Wo          , Wo          , Wo          , Wo          , Cv          , Cv          , Cv          , Cv          , Cv          , Gg^Vh       , Ss^Vm       , Uu^Vud      , Gg^Ve       , Hh^Vhh      , Dd^Vdt      , Aa^Vha      , Wo          , Wo          , Wo          
Wo          , Wo          , Wo          , Wo          , Wo          , Wo          , Wo          , Wo          , Wo          , Cv          , Cv          , Cv          , Gs^Vht      , Uu^Vu       , Mm^Vhh      , Ha^Vhha     , Wo^Bw\      , Wo          , Wo          , Wo          , Wo          , Wo          
Wo          , Wo          , Wo          , Wo          , Wo          , Wo          , Wo          , Wo          , Wo          , Wo          , Wo          , Wo          , Wo          , Wo          , Wo          , Wo          , Wo          , Wo^Bw\      , Wo^Bw\      , Wo          , Wo          , Wo          
Wo          , Wo          , Wo          , Wo          , Wo          , Wo          , Wo          , Wo          , Wo          , Wo          , Wo          , Wo          , Wo          , Wo          , Wo          , Wo          , Wo          , Wo          , Wo          , Wo^Bw\      , Wo^Bw|      , Wo          
Hd          , Wo          , Wo          , Wo          , Ds          , Wo          , Wo          , Wo          , Hd          , Wo          , Wo          , Wo          , Ds          , Ds          , Ds          , Wo          , Ds          , Wo          , Ds          , Wo          , Ds          , Wo          
Hd          , Hd          , Hd          , Ds          , Dd^Vdt      , Ds          , Ds          , Ds          , Hd          , Ww          , Wo^Bw/      , Wo^Bw/      , Ds          , Ds          , Ds          , Ds          , Ds          , Ds          , Ds          , Ds          , Ds          , Ds          
Hd          , Dd^Vdt      , Hd          , Ds          , Ds          , Dd^Vdt      , Ds          , Ds          , Hd          , Wo^Bw/      , Ww          , Ww          , Ds          , Ds          , Ds          , Ds          , Ds          , Ds          , Ds          , Ds          , Ds          , Ds          
Hd          , Hd          , Ce          , Ds          , Ds          , Dd^Vdt      , Hd          , Hd          , Ww          , Ww          , Ww^Vm       , Ww          , Ww          , Ds          , Ds          , Ds          , Ds          , Ds          , Ds          , Ds          , Ds          , Ds          
Hd          , Ce          , Dd^Vda      , Ce          , Ds          , Hd          , Ww          , Ww          , Ww          , Ww          , Chw         , Ww          , Ww^Vm       , Ww          , Ww          , Ds          , Ds          , Ds          , Gg^Vc       , Gg^Vc       , Gg^Vc       , Ds          
Hd          , Ce          , Ce          , Ce          , Ds          , Hd          , Ww          , Ww          , Ww^Vm       , Chw         , Chw         , Chw         , Ww          , Ww^Vm       , Ww          , Gg^Vc       , Gg^Vc       , Gg^Vc       , Gg^Vc       , Gg^Vc       , Gg^Vc       , Gg^Vc       
Hd          , Dd^Vdt      , Hd          , 4 Ce        , Hd          , Hd          , Ww          , Ww          , Ww          , Chw         , 2 Chw       , Chw         , Chw         , Ww          , Chw         , Gg^Vc       , Kv          , Gg^Vc       , Gg^Vc       , Gg^Vc       , Gg^Vc       , Gg^Vc       
Qlf         , Qlf         , Qlf         , Hd          , Ql^Bs|      , Qlf         , Qlf         , Ww^Vm       , Ww          , Chw         , Chw         , Chw         , Ww^Vm       , Chw         , Ai          , Ai          , Ai          , Kv          , 5 Kv        , Gg^Vc       , Kv          , Gg          
Uu^Ii       , Uu^Ii       , Uu^Ii       , Qlf         , Uu^Vu       , Uu^Ii       , Uu^Ii       , Qlf         , Qxu^Bs|     , Qlf         , Qlf         , Qlf         , Qlf         , Qlf         , Ai          , Ai          , Ai          , Kv          , Kv          , Kv          , Kv          , Gg          
Uu^Ii       , Uu^Ii       , Uu^Vu       , Uu^Vu       , Uu^Vu       , Uu^Vu       , Uu^Vu       , Uu^Ii       , Uu^Vu       , Uu^Ii       , Uu^Vu       , Uu^Ii       , Uu^Ii       , Qlf         , Qxu^Bs/     , Ai          , Ai          , Aa^Fpa      , Aa^Fpa      , Aa^Fpa      , Aa^Fpa      , Gg          
Uu^Ii       , Uu^Vu       , Uu^Vu       , Uu^Vu       , Uu^Vu       , Uu^Vu       , Uu^Vu       , Uu^Vu       , Uu^Vu       , Uu^Vu       , Uu^Vu       , Uu^Vu       , Uu^Vud      , Qxu^Bs/     , Aa^Fpa      , Aa^Fpa      , Aa^Vha      , Ai          , Ai          , Aa^Fpa      , Aa^Vha      , Aa          
Uu^Ii       , Uu^Vu       , Uu^Vu       , Uu^Vu       , Uu^Ii       , Uu^Vu       , Cud         , Uu^Vu       , Uu^Vu       , Qxu^Bs|     , Uu^Vu       , Uu^Vu       , Qlf         , Qlf         , Aa^Fpa      , Aa          , Aa          , Aa          , Aa          , Aa^Vha      , Aa^Vha      , Aa          
Uu^Ii       , Uu^Ii       , Uu^Ii       , Uu^Ii       , Cud         , Cud         , Cud         , Cud         , Uu^Vud      , Uu^Vud      , Uu^Vud      , Uu^Ii       , Qlf         , Aa^Fpa      , Aa          , Aa^Vha      , Aa          , Aa          , Khr         , Aa          , Aa          , Aa          
Uu^Ii       , Uu^Ii       , Uu^Ii       , Uu^Ii       , Cud         , 1 Kud       , Cud         , Cud         , Uu^Ii       , Uu^Vud      , Uu^Ii       , Qlf         , Aa^Fpa      , Aa^Fpa      , Aa          , Aa^Vha      , Aa          , Khr         , 3 Kh        , Khr         , Aa          , Aa          
Uu^Ii       , Uu^Ii       , Uu^Ii       , Uu^Ii       , Uu^Ii       , Cud         , Uu^Ii       , Uu^Ii       , Uu^Ii       , Uu^Ii       , Uu^Ii       , Ql^Bs\      , Aa^Fpa      , Ha^Vhha     , Aa          , Aa^Vha      , Aa          , Khr         , Khr         , Khr         , Ha^Vhha     , Aa          
Uu^Ii       , Uu^Ii       , Uu^Ii       , Uu^Ii       , Uu^Ii       , Uu^Ii       , Uu^Ii       , Uu^Ii       , Uu^Ii       , Uu^Ii       , Uu^Ii       , Qlf         , Aa          , Aa          , Aa          , Aa          , Aa          , Aa          , Aa          , Aa          , Aa          , Aa          
