border_size=1
usage=map

Gs^Fp       , Gs^Fp       , Gs^Fp       , Gs^Fp       , Gs^Fp       , Gs^Fp       , Gs^Fp       , Gs^Fp       , Gs^Fp       , Gs^Fp       , Gs^Fp       , Gs^Fp       , Gs^Fp       , Gs^Fp       , Gs^Fp       , Gs^Fp       , Gs^Fp       , Gs^Fp       , Gs^Fp       , Gg          , Gs^Fp       , Gg          , Gs^Fp       , Gs^Fp       , Gs^Fp       , Gs^Fp       , Gs^Fp       , Gs^Fp       , Gs^Fp       , Gs^Fp       , Gs^Fp       , Gs^Fp       , Gs^Fp       , Gs^Fp       , Gs^Fp       , Gs^Fp       , Gs^Fp       , Gs^Fp       , Gs^Fp       , Gs^Fp       , Gs^Fp       , Gs^Fp       
Gs^Fp       , Gs^Fp       , Gs^Fp       , Gs^Fp       , Gs^Fp       , Gs^Fp       , Gs^Fp       , Gs^Fp       , Gs^Fp       , Gs^Fp       , Gs^Fp       , Gs^Fp       , Gs^Fp       , Gs^Fp       , Gs^Fp       , Gs^Fp       , Gs^Fp       , Gs^Fp       , Gs^Fp       , Gs^Fp       , Gs^Fp       , Gs^Fp       , Gs^Fp       , Gs^Fp       , Gs^Fp       , Gs^Fp       , Gs^Fp       , Gs^Fp       , Gs^Fp       , Gs^Fp       , Gs^Fp       , Gs^Fp       , Gs^Fp       , Gs^Fp       , Gs^Fp       , Gs^Fp       , Gs^Fp       , Gs^Fp       , Gs^Fp       , Gs^Fp       , Gs^Fp       , Gs^Fp       
Gs^Fp       , Gs^Fp       , Gs^Fp       , Gs^Fp       , Gs^Fp       , Gs^Fp       , Gs^Fp       , Gs^Fp       , Gs^Fp       , Gs^Fp       , Gs^Fp       , Gs^Fp       , Gs^Fp       , Gs^Fp       , Gs^Fp       , Gs^Fp       , Gs^Fp       , Gs^Fp       , Gs^Fp       , Gs^Fp       , Gs^Fp       , Gs^Fp       , Kh          , Gs^Fp       , Gs^Fp       , Gs^Fp       , Gs^Fp       , Gs^Fp       , Gs^Fp       , Gs^Fp       , Gs^Fp       , Gs^Fp       , Gs^Fp       , Gs^Fp       , Gs^Fp       , Gs^Fp       , Gs^Fp       , Gs^Fp       , Gs^Fp       , Gs^Fp       , Gs^Fp       , Gs^Fp       
Gs^Fp       , Gs^Fp       , Gs^Fp       , Gs^Fp       , Gs^Fp       , Gs^Fp       , Gs^Fp       , Gs^Fp       , Gs^Fp       , Gs^Fp       , Gs^Fp       , Gs^Fp       , Gs^Fp       , Gs^Fp       , Gs^Fp       , Gs^Fp       , Kh          , Kh          , Kh          , Gg^Vh       , Kh          , Kh          , Kh          , Kh          , Kh          , Gs^Fp       , Kh          , Kh          , Kh          , Gs^Fp       , Gs^Fp       , Gs^Fp       , Gs^Fp       , Gs^Fp       , Gs^Fp       , Gs^Fp       , Gs^Fp       , Gs^Fp       , Gs^Fp       , Gs^Fp       , Gs^Fp       , Gs^Fp       
Gs^Fp       , Gs^Fp       , Gs^Fp       , Gs^Fp       , Gs^Fp       , Gs^Fp       , Gs^Fp       , Gs^Fp       , Gg^Vc       , Gs^Fp       , Gs^Fp       , Gs^Fp       , Gs^Fp       , Gs^Fp       , Gs^Fp       , Kh          , Kh          , Kh          , Kh          , Kh          , Kh          , Kh          , Ch          , Kh          , Kh          , Kh          , Kh          , Kh          , Kh          , Kh          , Gs^Fp       , Gs^Fp       , Gs^Fp       , Gs^Fp       , Gs^Fp       , Gs^Fp       , Gs^Fp       , Gs^Fp       , Gs^Fp       , Gs^Fp       , Gs^Fp       , Gs^Fp       
Gs^Fp       , Gs^Fp       , Gs^Fp       , Gs^Fp       , Gs^Fp       , Gs^Fp       , Gs^Fp       , Gs^Fp       , Gs^Fp       , Gs^Fp       , Gs^Fp       , Gs^Fp       , Gs^Fp       , Gs^Fp       , Gs^Fp       , Kh          , Kh          , Kh          , Kh          , Kh          , Ch          , Ch          , Ch          , Ch          , Ch          , Kh          , Kh          , Kh          , Kh          , Kh          , Gs^Fp       , Gs^Fp       , Gs^Fp       , Gs^Fp       , Gs^Fp       , Gs^Fp       , Gs^Fp       , Gs^Fp       , Gs^Fp       , Gs^Fp       , Gs^Fp       , Gs^Fp       
Gs^Fp       , Gs^Fp       , Gs^Fp       , Gs^Fp       , Gs^Fp       , Gs^Fp       , Gs^Fp       , Gs^Fp       , Gs^Fp       , Gs^Fp       , Gs^Fp       , Gs^Fp       , Gs^Fp       , Gs^Fp       , Gs^Fp       , Kh          , Kh          , Kh          , Kh          , Kh          , Ch          , Ch          , 1 Ch        , Ch          , Ch          , Kh          , Kh          , Kh          , Kh          , Kh          , Gs^Fp       , Gs^Fp       , Gs^Fp       , Gs^Fp       , Gs^Fp       , Gs^Fp       , Gs^Fp       , Gs^Fp       , Gs^Fp       , Gg^Vc       , Gs^Fp       , Gs^Fp       
Gs^Fp       , Gs^Fp       , Gs^Fp       , Gs^Fp       , Gs^Fp       , Gs^Fp       , Gs^Fp       , Gs^Fp       , Gs^Fp       , Gs^Fp       , Gs^Fp       , Gs^Fp       , Gs^Fp       , Gs^Fp       , Gs^Fp       , Gs^Fp       , Gs^Fp       , Kh          , Kh          , Kh          , Ch          , Ch          , Ch          , Ch          , Ch          , Kh          , Kh          , Kh          , Gs^Fp       , Gs^Fp       , Gs^Fp       , Gs^Fp       , Gs^Fp       , Gs^Fp       , Gs^Fp       , Gs^Fp       , Gs^Fp       , Gs^Fp       , Gs^Fp       , Gs^Fp       , Gs^Fp       , Gs^Fp       
Gs^Fp       , Gs^Fp       , Gs^Fp       , Gs^Fp       , Gs^Fp       , Gs^Fp       , Gs^Fp       , Gs^Fp       , Gs^Fp       , Gs^Fp       , Gs^Fp       , Gs^Fp       , Gs^Fp       , Gs^Fp       , Gs^Fp       , Gs^Fp       , Gs^Fp       , Gs^Fp       , Kh          , Kh          , Kh          , Ch          , Ch          , Ch          , Kh          , Kh          , Kh          , Gs^Fp       , Gs^Fp       , Gg^Vc       , Gs^Fp       , Gs^Fp       , Gs^Fp       , Gs^Fp       , Gs^Fp       , Gs^Fp       , Gs^Fp       , Gs^Fp       , Gs^Fp       , Gs^Fp       , Gs^Fp       , Gs^Fp       
Gs^Fp       , Gs^Fp       , Gs^Fp       , Gg^Vc       , Gs^Fp       , Gs^Fp       , Gs^Fp       , Gs^Fp       , Gs^Fp       , Gs^Fp       , Gs^Fp       , Gs^Fp       , Gs^Fp       , Gs^Fp       , Gs^Fp       , Gs^Fp       , Gs^Fp       , Gs^Fp       , Kh          , Kh          , Kh          , Kh          , Kh          , Kh          , Kh          , Kh          , Kh          , Gs^Fp       , Gs^Fp       , Gs^Fp       , Gs^Fp       , Gs^Fp       , Gs^Fp       , Gs^Fp       , Gs^Fp       , Gs^Fp       , Gs^Fp       , Gs^Fp       , Gs^Fp       , Gs^Fp       , Gs^Fp       , Gs^Fp       
Gs^Fp       , Gs^Fp       , Gs^Fp       , Gs^Fp       , Gs^Fp       , Gs^Fp       , Gs^Fp       , Gs^Fp       , Gs^Fp       , Gs^Fp       , Gs^Fp       , Gs^Fp       , Gs^Fp       , Gs^Fp       , Gs^Fp       , Gs^Fp       , Gs^Fp       , Gs^Fp       , Gs^Fp       , Kh          , Kh          , Kh          , Re          , Kh          , Kh          , Kh          , Gs^Fp       , Gs^Fp       , Gs^Fp       , Gs^Fp       , Gs^Fp       , Gs^Fp       , Gs^Fp       , Gs^Fp       , Gs^Fp       , Gs^Fp       , Gs^Fp       , Gs^Fp       , Gs^Fp       , Gs^Fp       , Gs^Fp       , Gs^Fp       
Gs^Fp       , Gs^Fp       , Gs^Fp       , Gs^Fp       , Gs^Fp       , Gs^Fp       , Gs^Fp       , Gs^Fp       , Gs^Fp       , Gs^Fp       , Gs^Fp       , Gs^Fp       , Gs^Fp       , Gs^Fp       , Gs^Fp       , Gg^Vc       , Gs^Fp       , Gs^Fp       , Gs^Fp       , Gs^Fp       , Gs^Fp       , Gs^Fp       , Re          , Gs^Fp       , Gs^Fp       , Gs^Fp       , Gs^Fp       , Gs^Fp       , Ce          , Gs^Fp       , Ce          , Gs^Fp       , Gs^Fp       , Gs^Fp       , Gs^Fp       , Gs^Fp       , Gs^Fp       , Gs^Fp       , Gs^Fp       , Gs^Fp       , Gs^Fp       , Gs^Fp       
Gs^Fp       , Gs^Fp       , Gs^Fp       , Gs^Fp       , Gs^Fp       , Gs^Fp       , Gs^Fp       , Gs^Fp       , Gs^Fp       , Gs^Fp       , Gs^Fp       , Gs^Fp       , Gs^Fp       , Gs^Fp       , Gs^Fp       , Gs^Fp       , Gs^Fp       , Gs^Fp       , Gs^Fp       , Gs^Fp       , Gs^Fp       , Gs^Fp       , Re          , Gs^Fp       , Gs^Fp       , Gs^Fp       , Gs^Fp       , Ce          , 6 Ce        , Ce          , Ce          , Gs^Fp       , Gs^Fp       , Gs^Fp       , Gs^Fp       , Gs^Fp       , Gs^Fp       , Gs^Fp       , Gs^Fp       , Gs^Fp       , Gs^Fp       , Gs^Fp       
Gs^Fp       , Gs^Fp       , Gs^Fp       , Gs^Fp       , Gs^Fp       , Gs^Fp       , Gs^Fp       , Gs^Fp       , Gs^Fp       , Gs^Fp       , Gs^Fp       , Gs^Fp       , Gs^Fp       , Gs^Fp       , Gs^Fp       , Gs^Fp       , Gs^Fp       , Gs^Fp       , Gs^Fp       , Gs^Fp       , Gs^Fp       , Gs^Fp       , Re          , Gs^Fp       , Gs^Fp       , Gs^Fp       , Gs^Fp       , Ce          , Ce          , Ce          , Ce          , Gs^Fp       , Gs^Fp       , Gs^Fp       , Gs^Fp       , Gs^Fp       , Gs^Fp       , Gs^Fp       , Gg^Vc       , Gs^Fp       , Gs^Fp       , Gs^Fp       
Gs^Fp       , Gs^Fp       , Gs^Fp       , Gs^Fp       , Gs^Fp       , Gs^Fp       , Gs^Fp       , Gs^Fp       , Gs^Fp       , Gs^Fp       , Gs^Fp       , Gs^Fp       , Gs^Fp       , Gs^Fp       , Gs^Fp       , Gs^Fp       , Gs^Fp       , Gs^Fp       , Gs^Fp       , Gs^Fp       , Gs^Fp       , Gs^Fp       , Re          , Gs^Fp       , Gs^Fp       , Gs^Fp       , Gs^Fp       , Gs^Fp       , Gs^Fp       , Gs^Fp       , Gs^Fp       , Gs^Fp       , Gs^Fp       , Gs^Fp       , Gs^Fp       , Gs^Fp       , Gs^Fp       , Gs^Fp       , Gs^Fp       , Gs^Fp       , Gs^Fp       , Gs^Fp       
Gs^Fp       , Gs^Fp       , Gs^Fp       , Gs^Fp       , Gg^Vc       , Gs^Fp       , Gs^Fp       , Gs^Fp       , Gs^Fp       , Gs^Fp       , Gs^Fp       , Gs^Fp       , Gs^Fp       , Gs^Fp       , Gs^Fp       , Gs^Fp       , Gs^Fp       , Gs^Fp       , Gs^Fp       , Gs^Fp       , Gs^Fp       , Gs^Fp       , Re          , Gs^Fp       , Gs^Fp       , Gs^Fp       , Gs^Fp       , Gs^Fp       , Gs^Fp       , Gs^Fp       , Gs^Fp       , Gs^Fp       , Gg^Vc       , Gs^Fp       , Gs^Fp       , Gs^Fp       , Gs^Fp       , Gs^Fp       , Gs^Fp       , Gs^Fp       , Gs^Fp       , Gs^Fp       
Gs^Fp       , Gs^Fp       , Gs^Fp       , Gs^Fp       , Gs^Fp       , Gs^Fp       , Gs^Fp       , Gs^Fp       , Re          , Re          , Re          , Re          , Re          , Re          , Re          , Re          , Re          , Re          , Re          , Re          , Re          , Re          , Re          , Gs^Fp       , Gs^Fp       , Gs^Fp       , Gs^Fp       , Gs^Fp       , Gs^Fp       , Gs^Fp       , Gs^Fp       , Gs^Fp       , Gs^Fp       , Gs^Fp       , Gs^Fp       , Gs^Fp       , Gs^Fp       , Gs^Fp       , Gs^Fp       , Gs^Fp       , Gs^Fp       , Gs^Fp       
Gs^Fp       , Gs^Fp       , Gs^Fp       , Gs^Fp       , Gs^Fp       , Gs^Fp       , Gs^Fp       , Gs^Fp       , Re          , Gg^Vc       , Re          , Gg^Vh       , Re          , Gg^Vh       , Re          , Gg^Vh       , Re          , Gg^Vh       , Re          , Gg^Ve       , Re          , Gg^Ve       , Re          , Gs^Fp       , Ww          , Ww          , Ww^Bw|      , Ww          , Ww          , Gs^Fp       , Ce          , Gs^Fp       , Ce          , Gs^Fp       , Ce          , Gs^Fp       , Gs^Fp       , Gs^Fp       , Cud         , Gs^Fp       , Gs^Fp       , Gs^Fp       
Gs^Fp       , Gs^Fp       , Gs^Fp       , Gs^Fp       , Gs^Fp       , Gs^Fp       , Gs^Fp       , Gs^Fp       , Re          , Gg^Vc       , Re          , Gg^Vh       , Re          , Gg^Vh       , Re          , Gg^Vh       , Re          , Gg^Vh       , Re          , Gg^Ve       , Re          , Gg^Ve       , Re          , Ww          , Ww          , Ww          , Chw         , Ww          , Ww          , Ww          , Ww          , Ce          , Ce          , Ce          , Ce          , Ce          , Cud         , Cud         , Cud         , Cud         , Cud         , Gs^Fp       
Gs^Fp       , Gs^Fp       , Gs^Fp       , Gs^Fp       , Gs^Fp       , Gs^Fp       , Gs^Fp       , Gg^Fet      , Re          , Gg^Vc       , Re          , Gg^Vc       , Re          , Gg^Vh       , Re          , Gg^Vh       , Re          , Gg^Vh       , Re          , Gg^Ve       , Re          , Gg^Ve       , Re          , Ww          , Ww^Bw/      , Chw         , 5 Chw       , Chw         , Ww^Bw\      , Ww          , Ww          , Ce          , Ce          , Ce          , Cud         , Cud         , Cud         , Cud         , Cud         , Cud         , Cud         , Gs^Fp       
Gs^Fp       , Gs^Fp       , Gs^Fp       , Gs^Fp       , Gs^Fp       , Gs^Fp       , Gs^Fp       , Gg^Fet      , Re          , Gg^Vc       , Re          , Gg^Vh       , Re          , Gg^Vh       , Re          , Gg^Vc       , Re          , Gg^Vh       , Re          , Gg^Ve       , Re          , Gg^Ve       , Re          , Ww^Bw/      , Ww          , Chw         , Chw         , Chw         , Ww          , Ww^Bw\      , Ww^Bw\      , Ce          , Ce          , Cud         , Cud         , Cud         , Cud         , Cud         , Cud         , Cud         , Cud         , Gs^Fp       
Gs^Fp       , Gs^Fp       , Gg^Vc       , Gs^Fp       , Gs^Fp       , Gs^Fp       , Gs^Fp       , Gg^Fet      , Re          , Gg^Vc       , Re          , Gg^Vh       , Re          , Gg^Vh       , Re          , Gg^Vh       , Re          , Gg^Vh       , Re          , Gg^Ve       , Re          , Gg^Ve       , Re          , Ww          , Ww          , Ww          , Ww          , Chw         , Ww          , Ww          , Cud         , Cud         , Ce          , Ce          , Ce          , Cud         , Cud         , Cud         , Cud         , Cud         , Cud         , Cud         
Gs^Fp       , Gs^Fp       , Gs^Fp       , Gs^Fp       , Gs^Fp       , Gs^Fp       , Gs^Fp       , Gg^Fet      , Gg^Fet      , Re          , Re          , Re          , Re          , Re          , Re          , Re          , Re          , Re          , Re          , Re          , Re          , Re          , Re          , Gg^Fet      , Gg^Fet      , Ww          , Ww          , Ww^Bw|      , Ww          , Ww          , Ce          , Ce          , Cud         , Ce          , Cud         , Cud         , Cud         , Cud         , Cud         , Cud         , Cud         , Cud         
Ha          , Gs^Fp       , Gs^Fp       , Gs^Fp       , Gs^Fp       , Gs^Fp       , Gs^Fp       , Gg^Fet      , Gg^Fet      , Gg^Fet      , Gg^Fet      , Gg^Fet      , Gg^Fet      , Gg          , Gg^Fet      , Gg^Fet      , Gg^Fet      , Gg^Fet      , Gs^Fp       , Re          , Gs^Fp       , Gs^Fp       , Re          , Gg^Fet      , Gg^Fet      , Gg^Fet      , Gg^Fet      , Ce          , Ce          , Ce          , Cud         , Cud         , Cud         , Cud         , Cud         , Cud         , 2 Kud       , Cud         , Cud         , Cud         , Cud         , Cud         
Ha          , Ha          , Ha          , Ha          , Ha          , Gs^Fp       , Gs^Fp       , Gs^Fp       , Gs^Fp       , Gg^Fet      , Gg^Fet      , Gg^Fet      , Gg^Fet      , Gg^Fet      , Gg^Fet      , Gg^Fet      , Gg^Fet      , Gg^Fet      , Gs^Fp       , Gs^Fp       , Gs^Fp       , Gs^Fp       , Re          , Gg^Fet      , Gg^Fet      , Gg^Fet      , Gg^Fet      , 7 Ce        , Ce          , Ce          , Cud         , Cud         , Cud         , Cud         , Cud         , Cud         , Cud         , Cud         , Cud         , Cud         , Cud         , Cud         
Ha          , Ha          , Ha          , Ha          , Ha          , Ha          , Ha          , Ha          , Ha          , Gs^Fp       , Ha          , Gg^Fet      , Gs^Fp       , Gg^Fet      , Gs^Fp       , Gg^Fet      , Gs^Fp       , Gs^Fp       , Gg^Vc       , Gs^Fp       , Gs^Fp       , Gs^Fp       , Re          , Gg^Fet      , Gg^Vc       , Gg^Fet      , Gg^Fet      , Ce          , Ce          , Ce          , Cud         , Cud         , Cud         , Cud         , Cud         , Cud         , Cud         , Cud         , Cud         , Cud         , Cud         , Cud         
Ha          , Ha          , Ha          , Ha          , Ha          , Ha          , Ha          , Ha          , Ha          , Ha          , Ha          , Ha          , Ha          , Gs^Fp       , Gs^Fp       , Gs^Fp       , Gs^Fp       , Gs^Fp       , Gs^Fp       , Gs^Fp       , Gs^Fp       , Gs^Fp       , Re          , Gg^Fet      , Gg^Fet      , Gg^Fet      , Gg^Fet      , Ce          , Ce          , Ce          , Ce          , Cud         , Cud         , Cud         , Cud         , Cud         , Cud         , Cud         , Cud         , Cud         , Cud         , Cud         
Ha          , Ha          , Ha          , Ha          , Ha          , Ha          , Ha          , Ha          , Ha          , Ha          , Ha          , Ha          , Ha          , Ha          , Ha          , Gs^Fp       , Gs^Fp       , Gs^Fp       , Gs^Fp       , Gs^Fp       , Re          , Re          , Re          , Gg^Fet      , Gg^Fet      , Gg^Fet      , Gg^Fet      , Gg^Fet      , Gg^Fet      , Ce          , Ce          , Cud         , Cud         , Cud         , Cud         , Cud         , Cud         , Cud         , Cud         , Cud         , Ce          , Ce          
Ha          , Ha          , Aa^Vea      , Ha          , Ha          , Ha          , Chr         , Ha          , Ha          , Aa^Vea      , Ha          , Ha          , Ha          , Ha          , Ha          , Ha          , Gs^Fp       , Gs^Fp       , Re          , Re          , Aa          , Aa          , Re          , Gg^Fet      , Gg^Fet      , Gg^Fet      , Gg^Fet      , Gg^Fet      , Gg^Fet      , Gg^Fet      , Gg^Fet      , Ce          , Ce          , Cud         , Ce          , Cud         , Ce          , Cud         , Ce          , Ce          , Gg^Fet      , Gg^Fet      
Ha          , Ha          , Ha          , Ha          , Chr         , Chr         , Khr         , Chr         , Chr         , Ha          , Ha          , Ha          , Ha          , Aa^Vea      , Ha          , Ha          , Re          , Re          , Aa          , Aa          , Re          , Re          , Re          , Gg^Fet      , Gg^Fet      , Gg^Fet      , Gg^Fet      , Gg^Fet      , Gg^Fet      , Gg^Fet      , Gg^Fet      , Gg^Fet      , Gg^Fet      , Ce          , Gg^Fet      , Ce          , Gg^Fet      , Ce          , Gg^Fet      , Gg^Fet      , Gg^Fet      , Gg^Fet      
Ha          , Ha^Vhha     , Ha          , Ha          , Chr         , Khr         , 3 Khr       , Khr         , Chr         , Ha          , Ha          , Aa^Vha      , Ha          , Ha          , Ha          , Ha          , Aa          , Aa          , Re          , Re          , Aa^Fpa      , Aa^Fpa      , Re          , Gg^Fet      , Gg^Fet      , Gg^Fet      , Gg^Fet      , Gg^Vc       , Gg^Fet      , Gg^Fet      , Gg^Fet      , Gg^Fet      , Gg^Fet      , Gg^Fet      , Hh          , Gg^Fet      , Hh          , Gg^Fet      , Hh^Vhh      , Gg^Fet      , Hh          , Gg^Fet      
Ha          , Ha          , Ha          , Ha          , Chr         , Khr         , Khr         , Khr         , Chr         , Ha          , Ha          , Ha          , Ha          , Ha          , Aa          , Aa          , Re          , Re          , Ai          , Aa^Fpa      , Ww^Bw|      , Aa^Fpa      , Re          , Gg^Fet      , Gg^Fet      , Gg^Fet      , Gg^Fet      , Gg^Fet      , Gg^Fet      , Gg^Fet      , Hh          , Hh          , Hh          , Hh          , Hh^Vhh      , Hh          , Hh          , Hh          , Hh          , Hh          , Hh          , Hh          
Ha          , Ha          , Aa^Vea      , Ha          , Ha          , Chr         , Chr         , Chr         , Ha          , Aa          , Aa          , Ha          , Aa          , Aa          , Re          , Re          , Ai          , Ai          , Ai          , Ai          , Ww^Bw|      , Ai          , Ai          , Re          , Re          , Gg^Fet      , Gg^Fet      , Gg^Fet      , Gg^Fet      , Hh          , Hh          , Hh          , Hh          , Hh          , Hh          , Hh          , Hh          , Hh          , Hh          , Hh          , Hh          , Hh          
Ha          , Ha          , Ha          , Ha          , Ha          , Ha          , Ha          , Ha          , Ha          , Ha          , Ha          , Aa          , Re          , Re          , Ai          , Ai          , Ai          , Ai          , Ai          , Ai          , Ww^Bw|      , Ai          , Ai          , Ai          , Ww^Bw/      , Re          , Re          , Gg^Fet      , Hh          , Hh          , Hh          , Hh          , Hh^Vhh      , Hh          , Hh          , Hh          , Hh          , Hh          , Hh          , Hh          , Hh          , Hh          
Ha          , Ha          , Ha          , Ha          , Ha          , Aa^Vha      , Ha          , Ha          , Ha          , Ha          , Ha          , Ha          , Ha          , Re          , Ai          , Ai          , Ai          , Ai          , Ww^Bw\      , Ai          , Ww^Bw|      , Ai          , Ww^Bw\      , Ww^Bw/      , Ai          , Ai          , Gg          , Re          , Re          , Hh          , Hh          , Hh          , Hh          , Hh          , Hh          , Hh          , Hh          , Hh          , Hh          , Hh^Vhh      , Hh          , Hh          
Ha          , Ha^Vhha     , Ha          , Ha          , Ha          , Ha          , Ha          , Ha          , Ha          , Ha          , Ha          , Aa^Vha      , Ha          , Re          , Ai          , Ai          , Ww^Bw/      , Ww^Bw/      , Ai          , Ww^Bw\      , Ww^Bw/      , Ww^Bw/      , Ai          , Ww^Bw\      , Ww^Bw\      , Ai          , Hh          , Hh          , Hh          , Re          , Re          , Hh          , Hh          , Hh          , Kv          , Hh          , Hh          , Hh          , Hh          , Hh          , Hh          , Hh          
Ha          , Ha          , Ha          , Ha          , Ha          , Ha          , Ha          , Ha          , Aa^Vha      , Ha          , Ha          , Ha          , Ha          , Re          , Ww^Bw/      , Ww^Bw/      , Ai          , Ai          , Ai          , Ai          , Ww^Bw|      , Ai          , Ai          , Ai          , Ai          , Ww^Bw\      , Hh          , Hh          , Hh          , Hh          , Hh          , Re          , Kv          , Kv          , Cv          , Kv          , Kv          , Hh          , Hh          , Hh          , Hh          , Hh          
Ha          , Ha          , Ha          , Ha^Vhha     , Ha          , Ha          , Ha          , Ha          , Ha          , Ha          , Ha          , Ha          , Ha          , Re          , Ai          , Ai          , Ai          , Ai          , Ai          , Ai          , Ww^Bw|      , Ai          , Ai          , Ai          , Ai          , Hh          , Hh          , Hh          , Hh          , Hh          , Hh          , Hh          , Kv          , Cv          , 4 Kv        , Cv          , Kv          , Hh          , Hh          , Hh          , Hh^Vhh      , Hh          
Ha          , Ha          , Ha          , Ha          , Ha          , Ha^Vhha     , Ha          , Ha          , Ha          , Ha          , Ha          , Ha^Vhha     , Re          , Re          , Aa^Fpa      , Ai          , Ai          , Ai          , Aa^Fpa      , Ai          , Ww^Bw|      , Ai          , Ai          , Ai          , Hh          , Hh          , Hh          , Hh          , Hh          , Hh          , Hh          , Hh          , Kv          , Cv          , Cv          , Cv          , Kv          , Hh          , Hh          , Hh          , Hh          , Hh          
Ha          , Ha          , Ha^Vhha     , Ha          , Ha          , Ha          , Ha          , Ha          , Ha          , Ha          , Ha          , Ha          , Aa^Fpa      , Aa^Fpa      , Aa^Fpa      , Aa^Fpa      , Aa^Fpa      , Aa^Fpa      , Aa^Fpa      , Aa^Fpa      , Aa^Fpa      , Aa^Fpa      , Aa^Fpa      , Aa^Fpa      , Hh          , Hh          , Hh^Vhh      , Hh          , Hh          , Hh          , Hh          , Hh          , Hh          , Kv          , Kv          , Kv          , Hh          , Hh          , Hh          , Hh          , Hh          , Hh          
Ha          , Ha          , Ha          , Ha          , Ha^Vhha     , Ha          , Ha          , Ha^Vhha     , Ha          , Ha          , Aa^Fpa      , Aa^Fpa      , Aa^Fpa      , Aa^Fpa      , Aa^Fpa      , Aa^Fpa      , Aa^Fpa      , Aa^Fpa      , Aa^Fpa      , Aa^Fpa      , Aa^Fpa      , Aa^Fpa      , Aa^Fpa      , Aa^Fpa      , Hh          , Hh          , Hh          , Hh          , Hh          , Hh          , Hh^Vhh      , Hh          , Hh          , Hh          , Hh          , Hh          , Hh          , Hh          , Hh          , Hh          , Hh          , Hh          
Gg          , Ha          , Gg          , Ha          , Gg          , Ha          , Gg          , Ha          , Aa^Fpa      , Aa^Fpa      , Aa^Fpa      , Aa^Fpa      , Aa^Fpa      , Aa^Fpa      , Aa^Fpa      , Aa^Fpa      , Aa^Fpa      , Aa^Fpa      , Aa^Fpa      , Aa^Fpa      , Aa^Fpa      , Aa^Fpa      , Aa^Fpa      , Aa^Fpa      , Hh          , Hh          , Hh          , Hh          , Hh          , Hh          , Hh          , Hh          , Hh          , Hh          , Hh          , Hh          , Hh          , Hh          , Hh          , Hh          , Gg          , Gg          
